################################################
#-----#------------------#---------------------#
#-----#------------------#---------------------#
#--------------------------------------#-------#
#------------------#-------------------#-------#
#----------------###--------------------#------#
#-----#-----------##--------####--------#------#
#-----#-----##----##-----------###-------#-----#
#----------###----##-------------##------------#
#----------------------------------------------#
#----------------------------------------------#
#---##-------------------##---------------##---#
#----#---------#---------##---------------#----#
#----#---------#--------------------------#----#
#----#--------##-----##-------------------#----#
#---##-------##------##-------------------##---#
#------------#--------------------#------------#
#---------------------------------#------------#
#---------------------------------#####--------#
#----------######------####--------------------#
#---------------#------#--#----------------#---#
#----------------------#--#---------------#----#
#----------------------#--#--------------#-----#
#---####--------------------------------#------#
#----------------------------------------------#
#----------------------------------------------#
################################################
