--------------------------------
--------------------------------
-----------#--------#-----------
-----------#--------#-----------
------------#------#------------
-------------######-------------
-------#----------------#-------
------#------------------#------
-----#--------------------#-----
-----#--------------------#-----
------#------------------#------
-------#----------------#-------
-------------######-------------
------------#------#------------
-----------#--------#-----------
-----------#--------#-----------
--------------------------------
--------------------------------
