-------#--------
--#-------------
-##--------#----
------------#---
----------------
-----#----------
---##--------##-
-------------#--
--------#-------
