0000000000000000000000000000000000000000000000000000000000000000
0111100000011111111111111111101111111111111111111111111111111110
0111111111111111111111111111101111111110000000011111111111111110
0111111111111111110000111111111111111111111111011111101110011110
0111111111111111111111111111111111111111111111011111100000001110
0110111100000001111111111111111111111111111111011111111111101110
0110111110111110111111100011110000000011111110011111111111111110
0110111110111111011111001100010111111111111110111111111111111110
0110111111111111101111111111000111111111111110111110111111111110
0110111111111111111111111111111111111111111110111110111001111110
0110000111111111111111111111111111111111111110111110000011111110
0111111111111111111110111222211200011111011111011111001111111110
0111111111111011111110112220022222201111011111011111011111111120
0110011111111011111100122200222222200111011111011111111111002220
0222001111111011111100122202222222221111011111011111111110022220
0222201111110011111100112222222222221111001111111111111110222220
0222200111110111111100111122222222211111101111111111111100222220
0222220111110111111100111022222222201111101111111111111102222220
0222200111111011111100111022222222201111101111111111111102222220
0222001111111001111110111002222220001111111111111111111102222220
0111111111111100011111111100002111111111111111111001111100222220
0111111111111111001111111101111111111111111111111001111110000220
0111111111111111101111111101111111111111111110000011111111110110
0111100011111111111111111101111100000111111111100111111111111110
0111111011101111111111111111111001111000011111111111111111111110
0111110011100111111110011111111011111111011111111111110000011110
0111110111110011111111100000110111111111111111111111110000011110
0111110011111100111111111110001111111111111111110011110000011110
0111111000111110011111111111111111110111111111000111110000011110
0110111100011111000011111111111111111001111000011111110000011110
0110111111001111110011111111111111111110000011111111111111111110
0110011111100111111111111000000111111111111111111111111111111110
0111000111110001111111111011110111111111111111111111111011111110
0111111111111100011111111111111111111111111111100000000011111110
0111111111111111000111111111111111111111111111111111111111111110
0000000000000000000000000000000000000000000000000000000000000000
