--------------------------------
--------------------------------
--------------------------------
---#----#--#####--#-------#-----
---#----#----#-----#-----#------
---#----#----#------#---#-------
---#----#----#------#---#-------
---#----#----#-------#-#--------
---##--##----#--------#---------
----#--#-----#-------#-#--------
----#--#-----#------#---#-------
----#--#-----#------#---#-------
----#--#-----#-----#-----#------
-----##----#####--#-------#-----
--------------------------------
--------------------------------
--------------------------------
--------------------------------
