------------#---
------------#---
----#-----------
----#---------##
-------##-------
##---------#----
-----------#----
---#------------
---#------------
