--------------------------------
--------------------------------
-------------#------------------
------------##------------------
-----------#-#------------------
----------#--#----#-------------
-----------#-#---#-#------------
------------##--#---#-----------
-------------#-#######----------
--------------#-----------------
-------#######-#----------------
--------#---#--##---------------
---------#-#---#-#--------------
----------#----#--#-------------
---------------#-#--------------
---------------##---------------
---------------#----------------
--------------------------------
